1111111111111111111111111111111111111111111
1000100000000000000000000000000000000000001
1000111100000000000000000000000000000000001
1000000110000000000000000000000000000000001
1000P00011000000000000000000000000000000001
1000000001100000000000000000000000000000001
1000000000110000000000000000000000000000001
1000000000011000000000000000000000000000001
1000000000001111110000000000000000000000001
1000000000000000000000000000000000000000001
1000000000000000000000000000000000000000001
1000000000000000000000000000000000000000001
1000000000000000000000000000000000000000001
1000000000000000000000000000000000000000001
1000000000000000000000000000000000000000001
1111111111111111111111111111111111111111111