        1111111111111111111      11111111111111111
        10000000010100010111     1110001000000001
        101101100000111110001111110000111111111111
111111111000000F0000000000000011111111
111111111011000001110000000000001
100000000001100000111011111111111
1111011111111101110000001000000111111
11110111111111000001101010010000000001
1100000011010101110000000010001111111
1000000000000000110000001000111
1000000000000001101010010011
110000011101010111110111100N111
1111011111101011011110100011
1111111111 1111111   1111111111