
        1111111111111111111      11111111111111111
        10000000010100010111     111000100000001
        101101100000111110001111110000111111111111
11111111100000000000000000000011111111
1111111110110000011100000000001
10000000000110000011101111111111111111
11110111111111011100000010000001111111
11110111111111000001101010010000000001
1100000011010101110000000100011111111
100010000000000110000001000111
1001 100000000001101010010011
1100100111010101111101111000111
111101111110101101111010N011111
1111111111 1111111   1111111111