    1    11111111111111111111      111111111111111     1
        10000000010100010011      1110001000000001
        10110110000011111000111111000011111111111
        1111111111111111111111111111111
111111111011000001110000000000001
10000000001100000111011111111111
11110111111111011100000010001
11110111111111011101010010001
11000000110101011100000010001
10000000000000001100000010001
10000000000000001101010010001
11000001110101011111011110N0111
1111011111101011011110100011
1111111111 1111111   1111111111