NO ./path_to_the_north_texture
SO ./path_to_the_south_texture
WE ./path_to_the_west_texture

EA ./path_to_the_east_texture

F 220,100,0
C 225,30,0

1111111111111111
1000000000000101
1010000011111011
101000N000000001
1111111101100001
1000000001100001
1110111111111011
1110111000111011
1100000110101011
1000000000000001
1001100000000001
1111111111111111

