NO ./../textures/red_brick.xpm
SO ./path_to_the_south_texture
WE ./path_to_the_west_texture

EA ./path_to_the_east_texture

F 220,100,0
C 225,30,0

 11111111111111111111111111
  10000000000001011
  101000000000000001
 1010000N0000000111
1000000001100001
1000000011000011
1110111111111011
1110111000111011
1100000110101011
1000000000000001
1001100000000001
11111111111111111
