






NO ./f
WE ./asdasasasdsa
F     201,123,122
SO   ./s
EA ./adsada
C     15,255,255        

111111111111111111111
  11000000000000000001
  100000000000000111001
  111111111111111111111
