NO ./path_to_the_north_texture
SO ./path_to_the_south_texture
WE ./path_to_the_west_texture

EA ./path_to_the_east_texture

F 220,100,0
C 225,30,0

        111111111111111111111111
        100000000000001000000001
        101100000111110101011001
        1001000N0000000000000011
11111111101100000110000000000001
10000000001100000111000111111111
11110111111111011100000010001
11110111111111011101010010001
11000000110101011100000010001
10000000000000001100000010001
10000000000000001101010010001
1100000111010101111101111011111
111101111110101101111010001
11111111 111111111111111111

