NO ./../textures/red_brick.xpm
SO ./../textures/red_wall.xpm
WE ./../textures/brick_purple.xpm

EA ./../textures/glowing_wall.xpm

F 105,105,105
C 135,206,250


111111111111
100110000001
100100000111
100100000001
100000N00001
100000000001
110001000001
100000000011
100110010001
111111111111